b07102030
b08208033
b04607057
b06504085
b08702043
b09107018
b07302260
b06207034
b05608028
b07305020
b07102066
b08703076
aoimiumiu
b08204013
b06501014
b08610016
b07701118
b08208007
b07303097
b08703062
b08607056
b07102034
t09303119
b07303062
b07302347
b07303067
t09701109
b07303141
t09109304
b07305045
t09109305
b08607044
t09303312
b08703072
b07702058
b08505051
b08102101
b08302243
b08703089
b08303136
b08607003
b07102050
b08303072
b08703058
b08605065
b09109034
b08207068
b07102128
b08303065
b07302149
b07606048
b07102085
b08106023
b08607006
r09323031
b07703020
b07610038
b08702082
b07607061
b08303028
b07703074
b08202031
b07702113
b06207035
b08203027
b08701221
b06602054
b06501028
b07201023
t09303307
b06502152
b08607038
b07302139
b06101033
b06901127
b07201046
b08302268
b05303135
b07103066
b07102108
b06703054
b06302355
b03702120
b08102020
b08203017
b08601015
b08310006
b08302258
b08302260
b07703071
b07607019
b07201017
b07b01031
b06607061
b08103055
b08703060
b07201016
b06705003
b07102052
b08303129
t08303211
b08703046
b07303034
b08107051
b06303018
b07610051
b07603037
30201
30202
30203
30204
30205
30206
30207
30208
30209
30210
40201
40202
40203
40204
40205
40206
40207
40208
40209
40210
